R 800 600
NO ./assets/textures/north.xpm
SO ./assets/textures/south.xpm
WE ./assets/textures/west.xpm
EA ./assets/textures/east.xpm
S ./assets/textures/sprite2.xpm
F 20,80,81
C 28,37,60
11111
10001
10001
11111
