R 1000 1000

NO ./assets/textures/WallNorth.xpm
SO ./assets/textures/WallSouth.xpm
WE ./assets/textures/WallWest.xpm
EA ./assets/textures/WallEast.xpm

F 255,255,255
C 60,60,100

11111111111111111111111
10000100S00000000000001
100000010100000000000011111111111111
111111000100000000000010000000000001
100000000100000000000010000000000001
100110000100000000000000000000000001
1000000101  100000000000000000000001
1011100001  100000000011111111111111
101 100001  11111111111
111 111111
