R 800 800

NO ./assets/textures/north.xpm
SO ./assets/textures/south.xpm
WE ./assets/textures/west.xpm
EA ./assets/textures/east.xpm

S ./assets/textures/sprite.xpm
F ./assets/textures/floor.xpm
C ./assets/textures/ceil.xpm

     11111
     10001
     10101
1111110001
1000000001
1001100001
1000000111
1011100001
101 100001
111 111111
