R 1000 1000

NO ./assets/textures/wall_n.xpm
SO ./assets/textures/wall_s.xpm
WE ./assets/textures/wall_w.xpm
EA ./assets/textures/wall_e.xpm

S ./assets/textures/sprite.xpm

F 255,255,255
C 60,60,100

1111111111111111
1000E00000000001
1000011111111111
102001
100001
111111
