R 1000 1000

NO ./assets/textures/wall_n.xpm
SO ./assets/textures/wall_s.xpm
WE ./assets/textures/wall_w.xpm
EA ./assets/textures/wall_e.xpm

F 255,255,255
C 60,60,100

111111
1000E1
100001
100001
100001
111111
