R 1000 1000
F 20,80,81
C 28,37,60

NO ./assets/textures/north.xpm
SO ./assets/textures/south.xpm
WE ./assets/textures/west.xpm
EA ./assets/textures/east.xpm
S ./assets/textures/sprite2.xpm

11111111111111111111111111111
10000000001100000000000000001
10110000011100000000100010001
10010000000000000001 10010001
10110000011100N00000100010001
10000000001100000111011110001
11110111111111011100000011111
11110111111111011101010010001
11000000110101011100000010001
10000000000000001100000010001
10000000000000001102010020001
11000000110101000000000000001
11110111110101000000202000001
10000000001100000100000010001
10000000000000002000200001001
10000000001000010000000001001
10000000001101000000000000001
10000000000100000001010000001
11111111111111111111111111111
